11111111111
10000E001C1
10R0000L101
10000C000L1
100L1010111
10001P101L1
11111111111
