111111111111111
100000C00100001
100C00000010001
111101111111111
100000000010001
100000000010001
100000000010001
101111100010001
101000100011111
101010100000001
101E10100000001
101110100000001
100000100000001
111111100000001
100000000000001
100000000000001
1C00000000P0001
111111111111111
