1111111111111111111111111111111111111111111
1000000000000001110000000000000000E00000001
1111100000000011C11000000000011000000011111
1P00000000000110001100000111110001100111001
1110000011000000000000001111000C00011100111
1100001111100011000000000000000001111111111
1111111111111111111111111111111111111111111
