111111111111
100000E111C1
100000000011
111000000001
1000P0011001
111111111111
